WWWWWWWWWWWWWWWWWWWW0000000000000000000000000000000000000WWWWWWWWWWWWWWWWWWWW
W111111111111111111WWWWWWWWWWWWWWWWWWWWWWWWWWWWWWWWWWWWWWW111111111111111111W
W111111111111111111***************************************1111111111111111>1W
W111111111111111111WWWWWWWWWWWWWWWWWWWWWWWWWWWWWWWWWWWWWWW111111111111111111W
W111111111111111111W0000000000000000000000000000000000000W1111111111O1111111W
W111111111111111111W0000000000000000000000000000000000000W111111111111111111W
W111111111111111111WWWWWWWWWWWWWW000000000000000000000000W111111111111111111W
W111111111111111111111111PP11RRRW000000000000000000000000W111111111111111111W
W111111111111111111111111PP11RRRW000000000000000000000000W111111111111111111W
W111111111111111111111111PP11RRRW000000000000000000000000WWWWWWWWWWWCWWWWWWWW
W111111111111111111WWWWWWWWWWWWWWWW0000000000000000000000WCCCCCCCCCCCCCCCCCCW
W111111111111111111W00000W11111111W0000000000000000000000WCCCCCCCCCCCCCCCCCCW
W111111111111111111WWWWWWW11111111W0000000000000000000000WCCCCCCCCCCCCCCCCCCW
W111111111111111111111W11111111111WWWWWWWWWWWWWWWWWWWW000WCCCCCCCCCCCCCCCCCCW
W11111111111111111111111111111E0111111111111111111111W000WCCCCCCCCC1CCCCCCCCW
W111111111111111111111W11111111111WWWWWWWWWWW11111111W000WCCCCCCCC1E1CCCCCCCW
W111111111111111111WWWWWWW11111111W000000000W11111111W000WCCCCCCCCC1CCCCCCCCW
W111111111111111111W00000W11111111W000000000W11111111W000WCCCCCCCCCCCCCCCCCCW
W111111111111111111W00000W111WWWWWW000000000WWWWW1WWWW000WWWWWWWWWWWWWWWWWWWW
WWWWWWWWW1WWWWWWWWWW00WWWW111W00000000000000000W11W
0000WWWWW1WWCCCCCCCCCCWWW111WW0000000000000000W11W
0000WWWWW1WWCCCCCCCCCCWW111WWW000000000000000W11W
0000WWWW111WCCCCE0CCCCW111WWWW00000000000000W11W
0000WWW111WWCCCCCCCCCCWW111WWW0000000000000W11W
0000WW111WWWCCCCCCCCCCWWW111WW000000000000W11W
0000W111WWWWCCCCCCCCCCWWWW111W00000000000W11W
0000WW111WWWCCCCCCCCCCWWW111WW0000000000W11W
0000WWW111WWCCCCCCCCCCWW111WWW000000000W11W
0000WWWW111WCCCCCCCCCCW111WWWW00000000W11W
WWWWWWWWCCCWWWWCWWWWWWWCCCWWWW0000000W11W
WCCCCCCCCCCCCCWCCCCCCCCCCCCCCW000000W11W
WCCCCCCCCCCCCCWCCCCCCCCCCCCCCW00000W11W
WCCCCCCCCCCCCCWCCCCCCCCCCCCCCW0000W11W
WCCCCCCCCCCCCCWCCCCCCCCCCCCCCW000W11W
WCCCCCCCCCCCCCCCCCCCCCCCCCCCCW00W11W
WCCCCCCCCCCCCCWCCCCCCCCCCCCCCW0W11W
WCCCCCCCCCCCCCWCCCCCCCCCCCCCCWW11W
WCCCCCCCCCCCCCWCCCCCCCCCCCCCC111W
WCCCCCCCCCCCCCWCCCCCCCCCCCCCC11W
WWWWWWWWWWWWWWWWWWWWWWWWWWWWWWW